##*#############
#   #    #######
# # #### #######
# # #### #######
# #           ##
######### ## ###
# #   ### ## ###
# # # ### ## ###
#   # ### ##  ##
# $ #####    ###
#     ###### ###
##### ##  ## ###
#              #
################

========================

##### ################################################
#.... ..............#...............#................#
#....  .............#...............#................#
#.....  ............#...............#................#
#.....  ............#............         ...........#
#......  ...........#.........    ..#..  ............#
#.......                       .....#..  ............#
#.......  ..........#...............#...   ..........#
#........  .........#...............#.....           $
#........  .........#...............#........ .......#
######### ###########################.......  .......#
#........ ..........#.....................   ........#
#........  .........#...................   ..........#
#........  .........#.................   ............#
#........  .........#................  ..............#
#.........  ........#...............  ...............#
# *                                  ................#
#...................#................................#
#...................#................................#
#...................#................................#
######################################################

========================

########################
### $  #################
##### ###########      *
#####   ######### ######
####### ######### ######
####### ########  ######
#######   ####   ## ####
######### #### #### ####
######### #### #########
#########   ##    ######
###########    ## ######
########################

========================

##################################
####  #########    ##       ######
### ########### ## ## ## ##  #####
###     #####   ##      ####    ##
#######         ######    ##   ###
####### #### ##  $ ###### ## # ###
###   # #### #######   ##   #   ##
##  ##   ### ##   ## # ## ##### ##
### ###         #    #    #####  #
### #### ###  ################## #
### ##  ##### ############  ##   #
### ## ######  ##########      # #
################################ *

========================

#######################################################
########       #######################          #######
########  #### #########      ######## ####  *  #######
######### ####  ######## #### ########  ###############
####     ######  ####### ####  ######## ###############
###  ###########   ##### #####     ###   ##############
####  ########### #####  ######## #### ################
### ############# ######  ####### #### ################
#       ######### ####### ####### #### ################
#       #########  ###### ######  ###   ###############
#       ##########    ### ###### #### #################
#####################     ######      #################
####################### ##########  #  ################
############    #######  ####      ###    #############
############ ##  ####### ###  ######### ###############
#######      ## ######## ### #########  ###############
####    ####### ########      ######## #####       ####
# ## ##    ##   ########### ########## #####       ####
# #  #### ## ## ######################  ####       ####
# ##  $ # ## ## ##   ##################            ####
#########    ##    ###########################   ######
###############                                ########
#######################################################
#######################################################

========================


###########################################################################
###################          ##########               ########## #### $  ##
####          ##### ######## ######### ######### ############### #### ## ##
#### ###### ####### ######## ###           ###### ############## #### ## ##
#### ###### ####### #####        ########  ###### ############## ###  ## ##
#### ###### ####### ##### ###### #######  ####### ############## ### ### ##
###     ###  ###### ##### #############  ######## ############## ### ### ##
### ### ####  ##### ##### ############  ######### ############## ### ### ##
### ### #####  #### ##### ###########                #########       ### ##
### ###  #####            ##########  ############## ######### ##  ##### ##
### #### ######## ####### #########  ############### ######### ###  #### ##
### #### ######## ####### ########################## ######### ####  ### ##
### #### ######   ####### ##########################  ######## #####   # ##
### #### ##   # ######### ##################### #### ######### ########  ##
#######     ###  ######## #########         ### #### ######### ############
#########  ##### ######## ######### ####### ### #### ######### ######    ##
########## ##### ################## ####### ### ####    ###### ###### ## ##
##########  #### #######    ####### ####### ### #######        ###### ## ##
######## * ##### ####### ## #######  ######  ## ##################### ## ##
######## #####   ####### ## ######  ####### ### ##########            ## ##
#######  ##### # ####### ## ###### ######    ## ########## ########## ## ##
####### ###### # ####### ## ###### ###### ##     ######### ########## ## ##
#######  ##    # ######  ## ###### ###### ### ## ######### ########## ## ##
######## ## ###  ###### ### ###### #####  ### ##      ####               ##
######## ## #    ###### ### ###### ####  #### ####### ##### ###############
######## ## # ## ###### ##         #### ##### ####### ###   ###############
########      ## ###### ##############  ####    ##### ### # ###############
########## ##### ###### ############## ###       ####     #         #######
################ ###### ##############              ############### #######
###############         #                                   ####### #######
###########################################################################
